tokidoki - czasami
zutto - ciągle
yoku - często
hajime-ni - na początku
tama-ni - rzadko
itsumo - zawsze
sorosoro - niebawem
mou - już
yukkuri - wolno, powoli
dandan - stopniowo
yoku - dobrze
hajimete - po raz pierwszy
pera-pera - płynnie (mówić)
hontou-ni - naprawdę
issho-ni - razem z
mochiron - oczywiście
chotto - troszkę
subete - całkowicie
tabun - prawdopodobnie
totemo - bardzo
sukoshi - trochę
choudo - dokładnie
hotondo - prawie
zenzen - wcale, w ogóle
amari - nie za bardzo
takusan - bardzo, dużo
hayaku - szybko
osoku - późno
yasuku - tanio
tanoshiku - radośnie
shinsetsu-ni - serdecznie
kirei-ni - pięknie, czysto
shizuka-ni - cicho, spokojnie
jouzu-ni - dobrze, wprawnie
