kaku - pisać
isogu - spieszyć się
dasu - wyjmować
matsu - czekać
shinu - umierać
iu - mówić
tobu - latać
yomu - czytać
wakaru - rozumieć
toru - wziąć
miru - oglądać
ochiru - spadać
taberu - jeść
deru - wychodzić
au - spotykać
kiku - słuchać
sagasu - szukać
kaeru - zmieniać
yobu - wołać
suu - palić, wsysać
nomu - pić
nugu - zdejmować
motsu - trzymać
hanasu - opowiadać
suru - robić
kuru - przychodzić
benkyousuru - uczyć się
soujisuru - sprzątać
sanposuru - spacerować
tetsudau - pomagać
neru - spać
iku - iść, jechać
aruku - iść pieszo
hairu - wchodzić
hashiru - biec
ireru - wkładać
kaeru - wracać
